########################
#                      #
#          #########   #
#%%%%%  ####           #
#####  #     ###########
#      #  ###          #
#      #  #            #
##### ## #    #####    #
#      #    ###        #
#    ########       ####
#       #              #
###  ####        #     #
#    #           #%%%%%#
#    #   ###############
#*   #                @#
########################