#                      #
#                      #
#                      #
#                      #
#                     *#
#  #%  %#%  %#%  %#%  ##
#                      #
##                     #
#                      #
#                      #
###  #  #  #  #  #  #  #
#                      #
#                     ##
#                      #
#@                     #
####%%#%%#%%#%%#%%#%%###