########################
#                      #
#                      #
#                      #
#                      #
#    #    #%%#%%#%%#%%##
#    #                 #
#    #                 #
#    #                 #
#    #%%#%%#%%#%%#%%#  #
#    #                 #
#    #                 #
#    #                 #
#    #    #%%#%%#%%#%%##
#*   #                @#
########################