########################
#                      #
#                      #
#                      #
#                      #
#*                    @#
###    #    #    #    ##
#                      #
#                      #
#                  ##  #
#                      #
#                      #
#               ##     #
#                      #
#                      #
########################