########################
#    #               @ #
#   @#    #          # #
#  %##   ##         ## #
#    #    #          # #
#    # #  #   #      # #
#    #    %       #  # #
##%  ##   %       #  # #
#    #    ##         # #
#    #  # #          # #
#    #    #     #    # #
#  %##    #          # #
#    ##   #         ## #
#    #    #          # #
#         #          #*#
########################