########################
#                      #
#     #####            #
#         #            #
#####     ##########   #
#         #            #
#         #            #
#   #######    #########
#       #      #       #
#       # ######       #
#       #      #       #
###  ######    #       #
#    #         #       #
#    #   #######       #
#@   #                *#
########################